█████████████████
█               █
█  Player INFO  █
█               █
█  HEALTH: 000  █
█  AMMO:    11  █
█               █
█████████████████