1111111111111111112222
1200000000010000000002
1000000000000100000002
1000000000000100000002
1200000000010000000002
1200000000011111111311
1111101111111111111011
1200000000011111111011
1200000000011111111011
1200000000011111111011
1200000000011111111011
1111131111111111111011
1200000000011111111011
1200000000011111111011
1200000000011111111011
1200000000011111111011
1111101111111111111011
1200000000011111111311
1200000000010100010011
1200000000000101010011
1200000000010101010111
1200000000010001000111
1111111111111111111111