1111111111111111112222
1200000000010000000002
1000000000000100000002
1000000000000100000002
1200000000010000000002
1200000000011111111012
1111111111111111112222