000000000000000000000000000000000000000000000000000000
000000000000000000000000000000000000000000000000000000
000000000000000000000000000000000000000000000000000000
000000000000000000011111111111110000000000000000000000
000000000000000000011111111111110000000000000000000000
000000000000000000011111111111110000000000000000000000
000000000000000000011111111111110000000000000000000000
000000000111111111111111111111111111111111000000000000
000000000111111111111111111111111111111111000000000000
000000000111111111111111111111111111111111000000000000
000000000111111111111111111111111111111111000000000000
000000000111111111111111111111111111111111000000000000
000000000000000000011111111111110000000000000000000000
000000000000000000011111111111110000000000000000000000
000000000000000000011111111111110000000000000000000000
000000000000000000011111111111110000000000000000000000
000000000000000000000000000000000000000000000000000000
000000000000000000000000000000000000000000000000000000
000000000000000000000000000000000000000000000000000000