███████████████████
███████    ████████
███████    ████████
████          █████
████          █████
███████    ████████
███████    ████████
███████████████████
███████████████████